\bvastra\s+goetalands\b	o
\bvastra\s+goetaland\b	o
\boestergoetlands\b	e
\bvasternorrlands\b	y
\boestergoetland\b	e
\bvastergoetland\b	e
\bvasternorrland\b	y
\bsodermanlands\b	d
\bvasterbottens\b	ac
\bjoenkoepings\b	f
\bsodermanland\b	d
\bvasterbotten\b	ac
\bvastmanlands\b	u
\bjoenkoeping\b	f
\bnorrbottens\b	bd
\bvastmanland\b	u
\bgavleborgs\b	x
\bkronobergs\b	g
\bnorrbotten\b	bd
\bstockholms\b	ab
\bgavleborg\b	x
\bjamtlands\b	z
\bkronoberg\b	g
\bstockholm\b	ab
\bvarmlands\b	s
\bblekinge\b	k
\bdalarnas\b	w
\bgotlands\b	i
\bhallands\b	n
\bjamtland\b	z
\boerebros\b	t
\bvarmland\b	s
\bdalarna\b	w
\bgotland\b	i
\bhalland\b	n
\boerebro\b	t
\bsverige\b	se
\buppsala\b	c
\bkalmar\b	h
\bsoeder\b	s
\bsweden\b	se
\bskane\b	m
\bnorr\b	n
\boest\b	o
\bvast\b	v
