Check to see that TimelineAgent record types are stable.

Applications outside of WebKit depend on the stability of the mapping of these types to these specific values.

{
    ActivateLayerTree : "ActivateLayerTree"
    BeginFrame : "BeginFrame"
    BeginMainThreadFrame : "BeginMainThreadFrame"
    CallStack : "CallStack"
    CancelAnimationFrame : "CancelAnimationFrame"
    CompositeLayers : "CompositeLayers"
    ConsoleTime : "ConsoleTime"
    CpuProfile : "CpuProfile"
    DecodeImage : "Decode Image"
    DecodeLazyPixelRef : "Decode LazyPixelRef"
    DrawFrame : "DrawFrame"
    DrawLazyPixelRef : "Draw LazyPixelRef"
    EmbedderCallback : "EmbedderCallback"
    EvaluateScript : "EvaluateScript"
    EventDispatch : "EventDispatch"
    FireAnimationFrame : "FireAnimationFrame"
    FunctionCall : "FunctionCall"
    GCEvent : "GCEvent"
    GPUTask : "GPUTask"
    InvalidateLayout : "InvalidateLayout"
    JSFrame : "JSFrame"
    JSSample : "JSSample"
    LayerInvalidationTracking : "LayerInvalidationTracking"
    LayerTreeHostImplSnapshot : "cc::LayerTreeHostImpl"
    Layout : "Layout"
    LayoutInvalidationTracking : "LayoutInvalidationTracking"
    LazyPixelRef : "LazyPixelRef"
    MarkDOMContent : "MarkDOMContent"
    MarkFirstPaint : "MarkFirstPaint"
    MarkLoad : "MarkLoad"
    Paint : "Paint"
    PaintImage : "PaintImage"
    PaintInvalidationTracking : "PaintInvalidationTracking"
    PaintSetup : "PaintSetup"
    ParseAuthorStyleSheet : "ParseAuthorStyleSheet"
    ParseHTML : "ParseHTML"
    PictureSnapshot : "cc::Picture"
    Program : "Program"
    RasterTask : "RasterTask"
    Rasterize : "Rasterize"
    RecalculateStyles : "RecalculateStyles"
    RequestAnimationFrame : "RequestAnimationFrame"
    RequestMainThreadFrame : "RequestMainThreadFrame"
    ResizeImage : "Resize Image"
    ResourceFinish : "ResourceFinish"
    ResourceReceiveResponse : "ResourceReceiveResponse"
    ResourceReceivedData : "ResourceReceivedData"
    ResourceSendRequest : "ResourceSendRequest"
    ScheduleStyleRecalculation : "ScheduleStyleRecalculation"
    ScrollLayer : "ScrollLayer"
    SetLayerTreeId : "SetLayerTreeId"
    StyleRecalcInvalidationTracking : "StyleRecalcInvalidationTracking"
    TimeStamp : "TimeStamp"
    TimerFire : "TimerFire"
    TimerInstall : "TimerInstall"
    TimerRemove : "TimerRemove"
    TracingSessionIdForWorker : "TracingSessionIdForWorker"
    TracingStartedInPage : "TracingStartedInPage"
    UpdateCounters : "UpdateCounters"
    UpdateLayer : "UpdateLayer"
    UpdateLayerTree : "UpdateLayerTree"
    WebSocketCreate : "WebSocketCreate"
    WebSocketDestroy : "WebSocketDestroy"
    WebSocketReceiveHandshakeResponse : "WebSocketReceiveHandshakeResponse"
    WebSocketSendHandshakeRequest : "WebSocketSendHandshakeRequest"
    XHRLoad : "XHRLoad"
    XHRReadyStateChange : "XHRReadyStateChange"
}

