\bkuyavian\s+pomeranian\b	kp
\bzachodniopomorskie\b	zp
\bwarmian\s+masurian\b	wn
\bwest\s+pomeranian\b	zp
\bgreater\s+poland\b	wp
\blower\s+silesian\b	ds
\bswietokrzyskie\b	sk
\blesser\s+poland\b	mp
\bsubcarpathian\b	pk
\bwielkopolskie\b	wp
\bdolnoslaskie\b	ds
\bpodkarpackie\b	pk
\bmalopolskie\b	mp
\bmazowieckie\b	ma
\bpomeranian\b	pm
\blubelskie\b	lu
\bmarszalek\b	marsz
\bpodlaskie\b	pd
\bpomorskie\b	pm
\bwarminsko\b	wn
\bkujawsko\b	kp
\blubuskie\b	lb
\bmasovian\b	ma
\bopolskie\b	op
\bpoludnie\b	south
\bsilesian\b	sl
\bwschodni\b	w
\bzachodni\b	z
\blodzkie\b	ld
\bosiedle\b	os
\bsilesia\b	sl
\bslaskie\b	sl
\blublin\b	lu
\blubusz\b	lb
\bpoland\b	pl
\bpolnoc\b	north
\bwschod\b	w
\bzachod\b	z
\bopole\b	op
\beast\b	w
\blodz\b	ld
\bwest\b	z
\bwlkp\b	wp
