\bавтодорога\b	а/д
\bнабережная\b	наб
\bтерритория\b	тер
\bпереулок\b	пер
\bпроспект\b	пр
\bбульвар\b	б-р
\bквартал\b	кв-л
\bплощадь\b	пл
\brussia\b	ru
\bдорога\b	дор
\bпроезд\b	пр-д
\bроссия\b	ru
\bбульв\b	б-р
\bлиния\b	лин
\bпр\-кт\b	пр
\bпросп\b	пр
\bтупик\b	туп
\bулица\b	ул
\bшоссе\b	ш
\bпрот\b	пр
\bбул\b	б-р
