\brepublic\s+of\s+south\s+africa\b	sa
\bkwazulu\s+natal\b	nl
\bnorthern\s+cape\b	nc
\beastern\s+cape\b	ec
\bkwazulunatal\b	nl
\bsouth\s+africa\b	sa
\bwestern\s+cape\b	wc
\bfree\s+state\b	fs
\bmpumalanga\b	mp
\bnoord\s+kaap\b	nc
\bnorth\s+west\b	nw
\bboulevard\b	blvd
\bfreestate\b	fs
\bnoordwes\b	nw
\boos\s+kaap\b	ec
\bvrystaat\b	fs
\bwes\s+kaap\b	wc
\bgauteng\b	gp
\bhighway\b	hwy
\blimpopo\b	lp
\bavenue\b	ave
\bstreet\b	st
\bdrive\b	dr
\bnatal\b	nl
\bsaint\b	st
\broad\b	rd
\bkzn\b	nl
\bgt\b	gp
\bza\b	sa
\bzn\b	nl
